15 20 
11 
B 10 3 
S 6 3 
C 1 1 
C 8 2 
C 4 6 
C 1 9 
C 9 10 
C 3 12 
C 7 7 
C 6 10 
C 12 12 
0 0 0 1 0 0 1 0 0 
0 0 1 1 1 0 0 1 1 
0 1 0 0 1 1 0 0 0 
1 1 0 0 0 0 0 0 0 
0 1 1 0 0 0 0 1 0 
0 0 1 0 0 0 0 1 0 
1 0 0 0 0 0 0 0 1 
0 1 0 0 1 1 0 0 0 
0 1 0 0 0 0 1 0 0 
.